000000000000000400000110000000000000000000000000000000000000000000000000000000000000000000000000000000000000000000000000
000000000000000000000000000000000000000000000000000000000000000000000000000000000000000000000000000000000000000000000000
000000000000000000000000000000000000000000000000000000000000000000000000000000000000000000000000000000000000000000000000
000005008040000000000000000000710000000000000000000000000000000000000000000000000000000000000000000000000000000000000000
000000222220000000900000000000110000000022220000000000000000000000000000000000000000000000000000000000000000000000000000
400000000000000000900000060000110000000000000000000000000000000000000000000000000000000000000000000000000000000000000000
220600007700000002200000622000220000000000000002200000022000000000000000000000000000000000000000000000000000000000000000
222222222222222222220000000000110000000000000000000000000000000000000000000000000000000000000000000000000000000000000000
111111111111111111100001111100111111111111111111100001111100000000000000000000000000000000000000000000000000000000000000
111111111111111111100000110000111111111111111111100000110000000000000000000000000000000000000000000000000000000000000000
111111111111111111100000100000111111111111111111100000100000000000000000000000000000000000000000000000000000000000000000
111000000000000000000000000000111111111111111111100000100000000000000000000000000000000000000000000000000000000000000000
111000000000000000000000000000111111111111111111100000000000000000000000000000000000000000000000000000000000000000000000
000000000000000000000000000000000000000000000000000000000000000000000200002222222222222222222000000000000000000000000000
000111111000000400000110000000000000000000000000000000000000002222200000000000000000000000000000000000000000000000000000
000000000000000000000000001000000000000000000000000000000000000000000000000000000000000000000000000000000000000000000000
000000000000000000000000000000100000088000000000000000002200000000000000000000000000000000000000000000000000000000000000
000000000040000000000000000000111111111111111000001000000000000000000000000000000000000000000000000000000000000000000000
000000222220000000000000000000900000000000000000000000000000000000000000000000000000000000000000000000000000000000000000
400000000000000000000000060000900000000000000000000000000000000000000000000000000000000000000000000000000000000000000000
220600007700005002201110622222220000000000000002200000022000000000000000000000000000000000000000000000000000000000000000
112223332222222221100002211200112222222222222221100002211200000000000000000000000000000000000000000000000000000000000000
111111111111111111100001111100111111111111111111100001111100000000000000000000000000000000000000000000000000000000000000
111111111111111111100000110000111111111111111111100000110000000000000000000000000000000000000000000000000000000000000000
111111111111111111100000100000111111111111111111100000100000000000000000000000000000000000000000000000000000000000000000
111111111111111111100000100000111111111111111111100000100000000000000000000000000000000000000000000000000000000000000000
111111111111111111100000000000111111111111111111100000000000000000000000000000000000000000000000000000000000000000000000
000000000000000000000000000000000000000000000000000000000000000000000000000000000000000000000000000000000000000000000000





